6,101,65,26,70,55,81,76,207,59
58,146,27,200,153,113,192,17,168,116
154,85,206,44,13,40,52,147,97,48
90,156,42,124,45,195,171,194,87,177
46,128,74,71,121,188,223,83,43,24
19,107,31,115,49,189,64,78,139,91
4,222,120,3,18,211,2,208,138,163
38,152,11,162,228,166,110,105,109,62
35,53,56,179,214,225,41,8,150,7
137,67,230,150,185,160,104,185,144,33