{
  "name": "TEST_MAP_1",
  "tileOptions": {
    "offset": {
      "y": -24,
      "x": 0
    },
    "width": 36,
    "height": 50
  },
  "tiles": [
    [12, 45, 78, 3, 199, 56, 34, 123, 67, 5],
    [98, 54, 32, 76, 8, 211, 23, 47, 101, 189],
    [155, 22, 7, 66, 87, 33, 145, 209, 12, 0],
    [67, 13, 200, 99, 45, 76, 32, 167, 88, 2],
    [109, 64, 31, 77, 12, 54, 210, 8, 44, 177],
    [3, 222, 99, 17, 68, 43, 121, 189, 6, 99],
    [88, 7, 90, 15, 72, 108, 65, 21, 87, 11],
    [34, 156, 9, 76, 33, 177, 14, 55, 98, 123],
    [66, 21, 224, 65, 43, 2, 155, 8, 176, 66],
    [22, 87, 44, 111, 199, 31, 65, 0, 144, 230]
  ]
}
